globalConst	LITERAL1
globalLiteral	LITERAL1
literalNoSpace	LITERAL1
globalFuncDec	KEYWORD2
TestClass	KEYWORD1
classLiteral	LITERAL1
classLiteralNoSpace	LITERAL1
defaultSpecifier	KEYWORD1
privateSpecifier	KEYWORD1
parentClass	KEYWORD1
childPrivateClass	KEYWORD1
childPublicClass	KEYWORD1
emptyClass	KEYWORD1
publicFunction	KEYWORD2
publicFunctionNoArgs	KEYWORD2
publicStruct	KEYWORD1
enum1	KEYWORD1
privateFunction	KEYWORD2
privateFunctionStatic	KEYWORD2
privateFunctionInline	KEYWORD2
pubClassAfterFunc	KEYWORD1
globalFuncDef	KEYWORD2
